||
0|1|1||F
0|1|1|H|E
0|1|1|F|
0|1|1|K|K
0|1|1|A|I
0|1|1|F|B
0|1|1|K|G
0|1|1|F|B
0|1|1|H|L
0|1|1|E|C
0|1|1|K|J
0|1|1||G
0|1|1|L|
0|1|1|J|C
0|1|1||A
0|1|1|K|L
0|1|1|F|F
0|1|1|C|L
0|1|1|E|A
0|1|1|H|A
0|1|1|A|A
0|1|1|G|A
0|1|1|G|G
0|1|1|C|
0|1|1|H|F
